en	es	mixtec
hair	pelo	ixí
head	cabeza	xi̠ní
face	cara	nu̠ú
forehead	frente	
eye	ojo	nduchí nu̠ú
nose	nariz	xi̠tin
mouth	boca	yu'ú
chin	barbilla	
ear	oreja	so̠'o
neck	cuello	
shoulder	hombro	
arm	brazo	
elbow	codo	
chest	pecho	
breast	seno	ndosó
hip	cadera	
thigh	muslo	
knee	rodilla	
leg	pierna	
ankle	tobillo	
foot	pie	xa̠'á
heel	talon	
toe	dedo de pie	
hand	mano	nda'á
finger	dedo de mano	
abdomen	panza	ti̠xin
genital area	partes privados	ña ítia

